1111111
1110001
1P1CE01
1111111