1111111
1FFFF01
100CE01
1111111